border_size=1
usage=map

Gg          , Gg          , Gg          , Gg          , Gg          , Gg          , Gg          , Ss          , Ss          , Ss          , Ww          , Gg          , Ww          , Ss          , Ss          , Gg          , Ss          , Gg          , Gg          , Gs^Fp       , Gs^Fp       , Gs^Fp       , Gs^Fp       , Gs^Fp       , Gs^Fp       , Gs^Fp       , Gs^Fp       , Gg          , Rp          , Rp          , Gg          , Gg          
Gg          , Gg          , Ss          , Gg          , Gg          , Gg          , Gg          , Ss          , Ss          , Ss          , Gg          , Ww          , Ww          , Ss          , Ss          , Ss          , Ss          , Ss          , Ss^Bw/      , Rp          , Rp          , Gs^Fp       , Gs^Fp       , Gs^Fp       , Gs^Fp       , Gs^Fp       , Rp          , Rp          , Gg          , Gg^Vh       , Gg          , Gg          
Gg          , Gg          , Ww          , Ss          , Ss          , Gg          , Gg          , Gg          , Gg          , Gg          , Gg^Vh       , Gg          , Gg          , Ss          , Ww          , Ss          , Ss^Bw/      , Ss^Bw/      , Ss          , Ss          , Ss          , Rp          , Rp          , Gg          , Rp          , Rp          , Ce          , Gg          , Gg          , Gg          , Gg          , Gg          
Ww          , Ss^Vhs      , Ss          , Ww          , Ww          , Ww          , Gg          , Gg          , Gg          , Gg          , Gs^Fp       , Gg          , Gg          , Ss          , Ss^Bw/      , Ww^Bw/      , Ww          , Ww          , Ss          , Ww          , Ww          , Ss          , Ww          , Rp          , Gg          , Ce          , 1 Ke        , Ce          , Gg          , Gg          , Gs^Fp       , Gg          
Gg          , Ww          , Gg          , Ss          , Ss          , Ss          , Ss          , Gg          , Gg          , Gs^Fp       , Gg          , Gs^Fp       , Gg          , Gg          , Gg          , Ss          , Gg          , Chs         , Ss          , Ww          , Ww          , Ss          , Ww          , Ww          , Gg          , Ce          , Ce          , Ce          , Gg          , Gg          , Gs^Fp       , Gs^Fp       
Gg          , Ss          , Ww          , Ss          , Ww          , Ww          , Ss          , Ww          , Gg          , Gg          , Gg          , Gs^Fp       , Gs^Fp       , Gg          , Ss          , Gg          , Ss^Bw\      , Gg          , Ss          , Ss          , Ss          , Ss          , Ss          , Ww          , Gg          , Gg          , Gg          , Gg          , Gs^Fp       , Gs^Fp       , Gs^Fp       , Gs^Fp       
Gg          , Ss          , Ww          , Ss          , Ss          , Ww          , Ss          , Gg          , Gg          , Gg          , Gg          , Gg          , Gg          , Gg          , Ss          , Ss          , Gg          , Ss          , Ss^Vhs      , Ss          , Ss          , Ss          , Ss          , Ss          , Ww          , Gg^Vh       , Gg          , Gg          , Gs^Fp       , Gs^Fp       , Gs^Fp       , Gs^Fp       
Gg          , Ww          , Ss          , Ss          , Ss          , Ss^Vhs      , Ww          , Gg          , Gg          , Ww          , Ww          , Gg          , Ss          , Gg          , Gg          , Ss          , Gg          , Gg          , Ss          , Ss          , Ss^Bw\      , Ww          , Ss          , Ss          , Ss          , Ww          , Gg          , Gg          , Gg          , Gg          , Gg          , Gs^Fp       
Gg          , Gg          , Gg          , Ss          , Ss          , Ss          , Ss^Bw/      , Ww^Bw/      , Ww          , Gg          , Ss          , Ss          , Ss          , Ww          , Ww          , Ss          , Ss          , Ss          , Ss          , Ww          , Ww          , Rp          , Rp          , Ss          , Ss^Bw/      , Ss^Bw/      , Ss          , Gg          , Gg          , Gg          , Gg          , Gg          
Gg          , Gg          , Ss          , Ss          , Ww          , Gg          , Gg          , Ss          , Ww          , Ss^Bw|      , Ss          , Ss          , Ww          , Ss          , Ss          , Ww          , Gg          , Ss          , Gg          , Ss          , Gg          , Gg          , Rp          , Rp          , Ss          , Ss          , Chs         , Ss          , Ww          , Gg          , Gg          , Gg          
Gg          , Gg          , Gg          , Gg          , Gg          , Gg^Vh       , Gg          , Gg          , Ss          , Ww^Bw|      , Ss          , Ww          , Ww          , Ss          , Gg          , Ss          , Ss          , Gg          , Gg          , Ss          , Ss^Bw/      , Rp          , Gs^Fp       , Ww          , Ww          , Ss          , Ss          , Ss          , Ww          , Ww          , Ww          , Gg          
Gg          , Gg          , Gg          , Ss          , Ww          , Gg          , Ss          , Ww          , Ss          , Ss          , Ss          , Ss          , Ww          , Ww          , Ww          , Ss^Vhs      , Ss          , Ss          , Ss          , Ss          , Gg          , Gg          , Ww          , Ww          , Ss          , Ww          , Ss^Bw/      , Gg          , Ss          , Ss          , Ss          , Gg          
Gg          , Gg          , Gg          , Ss          , Ss          , Ww          , Ss          , Ww          , Ww          , Ss^Bw|      , Ss          , Ww          , Ww          , Ss          , Ss          , Ss          , Ss^Bw/      , Ss^Bw/      , Ss          , Ss          , Ww          , Gg          , Ss          , Gg          , Ss^Bw/      , Ss^Bw/      , Gg          , Ww          , Ss          , Ss^Bw/      , Ss          , Ss          
Gg          , Gg          , Gg          , Gg          , Gg          , Ss          , Gg          , Ss          , Ww          , Ww^Bw|      , Ww          , Ss          , Ss          , Ss          , Ss          , Rp          , Ss          , Ss          , Ww          , Ss          , Gg          , Ss          , Ss^Bw/      , Ss          , Ss          , Gg          , Gg          , Gg          , Gg          , Ss          , Ss          , Ss          
Gg          , Gg          , Gg          , Gg          , Gg          , Ss          , Ww          , Ss          , Gg          , Gg          , Gg          , Ss          , Ss          , Ww          , Ww          , Ss          , Chs         , Ss          , Gg          , Ss          , Ww^Bw/      , Ww^Bw/      , Ss          , Ss          , Ss          , Gg          , Gs^Fp       , Gs^Fp       , Gg^Vh       , Gg          , Gg          , Ss          
Gg          , Gg          , Rp          , Gg          , Ss          , Ss^Vhs      , Gg          , Gg          , Gs^Fp       , Gg          , Ww          , Chs         , Ss          , Ss          , Ss          , Ss          , Ss          , Gg          , Ss          , Ww^Bw/      , Ss          , Ss          , Chs         , Ss          , Gg          , Gg          , Gg          , Gg          , Ss          , Gg          , Gg          , Gg          
Gg          , Gg^Vh       , Rp          , Rp          , Chs         , Ss          , Gg          , Gs^Fp       , Gs^Fp       , Gg          , Gg          , Ww          , Ss          , Ss^Vhs      , Gg          , Gg          , Ww^Bw/      , Ww          , Ss          , Ww          , Ss          , Ss          , Ss          , Ss          , Gg          , Gg          , Gg          , Ss          , Ss          , Ss^Vhs      , Ss          , Gg          
Gg          , Rp          , Rp          , 2 Khs       , Chs         , Ss          , Ss          , Gg          , Gg          , Gs^Fp       , Gs^Fp       , Gg          , Ww          , Ss          , Ss          , Ss          , Ss          , Ww          , Ww          , Ss          , Ss          , Ss          , Ww          , Ss^Vhs      , Ww          , Gg          , Gg          , Ww          , Ww          , Ss          , Ss          , Gg          
Gg          , Rp          , Rp          , Rp          , Gg          , Ss          , Ss          , Gg          , Gg          , Gs^Fp       , Gg          , Gg          , Ss          , Ss          , Gg          , Ww          , Ww          , Ss          , Ss          , Ss          , Ss          , Ss          , Ss          , Ss          , Ss          , Gg          , Gg          , Gg          , Gg          , Ss          , Gg          , Gg          
Gg          , Gg          , Chr         , Rp          , Gg          , Gg          , Ss          , Ss          , Gg          , Gg          , Ww          , Ww          , Ss          , Ss          , Ss          , Ww^Bw\      , Gg          , Gg          , Ww          , Ww          , Ww          , Ss          , Ss^Bw/      , Ww          , Ss          , Gg          , Ww          , Gg          , Gg          , Gg          , Gs^Fp       , Gg          
Gg          , Gg          , Rp          , Rp          , Gg          , Ss          , Ss          , Gg          , Ww          , Ss^Vhs      , Ss          , Ss          , Ss          , Ss          , Ss          , Ww          , Gg          , Ww^Bw\      , Gg          , Gg^Vh       , Ss          , Ss          , Ss          , Ss          , Ss          , Ss          , Ss          , Gg          , Ss          , Gg          , Gg          , Gg          
Gg          , Gg          , Gg          , Gg          , Ww          , Ss          , Ss          , Gg          , Ss          , Ss          , Gg          , Ww          , Ww          , Ww          , Ss          , Ss          , Ss          , Ww          , Ss^Bw|      , Gg          , Ss          , Ss          , Ss          , Chs         , Ss          , Ww          , Ss          , Ss          , Ss          , Gg          , Gg          , Gg          
Gg          , Gg          , Ss          , Ss          , Ss          , Ss          , Ss          , Ww          , Ww          , Ss          , Ww          , Ss          , Ss          , Ss          , Ww          , Ss          , Ss          , Ss          , Ss^Bw|      , Ww          , Ww          , Ss          , Ww          , Gg          , Ww^Bw/      , Gg          , Ss          , Ss          , Ss          , Ss          , Ss          , Gg          
Gg          , Gg          , Ss          , Ss          , Ss          , Ww^Bw|      , Ss          , Ss          , Ss          , Gg          , Ww          , Ss          , Ww          , Ww          , Ww          , Ss          , Ss^Vhs      , Ss          , Ss^Bw|      , Ss          , Ww          , Ss          , Rp          , Rp          , Ww          , Ss          , Gg          , Ss          , Ss^Vhs      , Gg          , Ss          , Gg          
Gg          , Ss          , Ss          , Ww          , Ww          , Ss^Bw|      , Ss          , Gg          , Ss          , Ww          , Gg          , Chs         , Ww          , Ww          , Ww          , Ww          , Gg          , Ww          , Ss^Bw|      , Ss          , Ss          , Ss          , Ww          , Ww          , Ww          , Ww          , Ww          , Gg          , Ss          , Ss          , Gg          , Gg          
Gg          , Gg          , Ss          , Ss          , Ss          , Gg          , Ww          , Ss          , Ss          , Ss          , Ww          , Gg          , Ww          , Ww          , Ww          , Ss          , Ss          , Ww          , Ww^Bw|      , Ss          , Gg          , Ss          , Ss          , Gg          , Gg          , Ww          , Ww          , Gg          , Ss          , Ss          , Ss          , Gg          
Gg          , Gg          , Gg          , Gg          , Gg          , Gg          , Ss          , Ww          , Ss          , Ss          , Ss          , Ss          , Ss          , Gg          , Ww          , Ww          , Ss          , Ww          , Gg          , Ww          , Gg          , Ww          , Ss          , Ss          , Ss          , Ww          , Ww          , Gg          , Gg          , Ww          , Ss          , Ww          
Gg          , Gg          , Rp          , Rp          , Gg          , Gg          , Ss          , Ss          , Ss^Vhs      , Ss          , Gg          , Ss          , Ss          , Ss          , Ss^Bw/      , Gg          , Ww^Bw\      , Ww          , Ww^Bw|      , Ww          , Ss          , Ss          , Gg          , Ss          , Ss          , Ww          , Ww^Bw/      , Ww^Bw/      , Ww          , Ss          , Ss          , Ww          
Gg          , Gg          , Gg^Vh       , Gg          , Gg          , Gg          , Ss          , Ss          , Gg          , Gg          , Gg          , Ss          , Rp          , Ss^Bw/      , Ss          , Ss          , Ww          , Ww          , Gg          , Ss          , Ww          , Gg          , Gg          , Ss          , Rp          , Ss^Bw/      , Ss^Vhs      , Gg          , Ww          , Ww          , Ss          , Ss          
Gg          , Gg          , Gg          , Gg          , Chs         , Ss          , Ss          , Gg          , Rp          , Gg          , Rp          , Rp          , Gg          , Ss          , Ss          , Ss          , Ss          , Ww          , Ww^Bw|      , Gg^Vh       , Ss          , Ss          , Ww          , Rp          , Gg          , Ww          , Ss          , Gg          , Ww          , Ss          , Ss          , Gg          
Gg          , Rp          , Gg          , Chr         , 3 Khr       , Chs         , Gg^Vh       , Gg          , Rp          , Rp          , Gs^Fp       , Gg          , Gg^Vh       , Gg          , Ss          , Chs         , Ss          , Ss          , Ww          , Ss          , Ss          , Ww          , Gg          , Gg          , Gg          , Ww          , Ss          , Ww          , Ss          , Ss          , Chs         , Gg          
Gg          , Rp          , Rp          , Chr         , Chr         , Chr         , Rp          , Rp          , Gg          , Gg          , Gs^Fp       , Gg          , Gg          , Gg          , Ss          , Ss          , Ss^Bw/      , Ss^Bw/      , Ww          , Ss          , Gg          , Gg          , Gs^Fp       , Gs^Fp       , Gg          , Ww          , Gg          , Ss          , Ww          , Ss          , Gg          , Gg          
Rp          , Rp          , Rp          , Rp          , Rp          , Rp          , Gg          , Gg          , Gg          , Gg          , Gg          , Gg          , Gg          , Ss          , Ss          , Ss          , Ss          , Ss          , Ss          , Ss          , Gg          , Gg          , Gg          , Gg          , Gg          , Ww          , Ww          , Ww          , Gs^Fp       , Gg^Ve       , Gg          , Gg          
Rp          , Rp          , Gg          , Gg          , Gg          , Gg          , Gg          , Gg          , Gg          , Gg          , Gg          , Gg          , Gg          , Gg          , Gg          , Ww          , Ww          , Ss          , Ss          , Ww          , Gg          , Gg          , Gg          , Gg          , Gg          , Gg          , Gg          , Ww          , Gg          , Gg          , Gg          , Gg          
