border_size=1
usage=map

Gs^Fds, Gs^Fds, Gd^Fdf, Hhd^Fdf, Gd^Fdf, Hh, Gs^Fds, Gg, Gs, Gs, Re, Gs, Gs^Fds, Gs^Fds, Gs^Fds, Hhd^Fmf, Gd^Fdf, Gd^Fdf, Gd^Fdf, Gd^Fdf, Gs^Fds, Gs^Fds, Hh, Hh, Hh, Gs^Fds, Hhd^Fdf, Hhd^Fdf, Hhd^Fdf, Mm, Mm^Xm, Mm^Xm, Mm^Xm, Mm^Xm, Mm^Xm, Mm^Xm, Mm^Xm
Gs^Fds, Gs^Fds, Gll^Fmf, Gd^Fdf, Hh^Fds, Hh^Fds, Gs^Fds, Gs^Fds, Gg, Gs, Re, Re, Gs, Gs^Fp, Gs^Fp, Hhd^Fmf, Hhd^Fmf, Gd^Fdf, Hhd^Fmf, Gd^Fdf, Hh, Hh, Hh, Hh, Gs^Fp, Gs^Fds, Gs^Fp, Gs^Fp, Hhd^Fdf, Mm, Mm, Mm^Xm, Mm^Xm, Mm^Xm, Mm^Xm, Mm^Xm, Mm^Xm
Gd^Fdf, Gll^Fmf, Gll^Fmf, Hhd^Fdf, Gs^Fp, Hh^Fds, Gg, Gg, Ce, Gg^Vh, Gg, Re, Gg, Gs^Fp, Gs^Fp, Gs^Fp, Gs^Fp, Hhd^Fmf, Gs^Fp, Gs^Fp, Hh, Hh, Hh, Hh, Hh, Gs^Fp, Hh, Gs^Fp, Gs^Fp, Mm, Hh^Fms, Mm, Mm, Mm^Xm, Md, Mm^Xm, Mm^Xm
Hh, Hhd^Fdf, Hh, Hh^Fp, Hh^Fp, Gs^Fp, Gg, Ce, 1 Ke, Ce, Gg, Gs, Gg, Gg, Gg, Gg, Gg, Gs^Fp, Gs^Fp, Gs^Fp, Gs^Fp, Gg, Gg, Gg, Gg, Hh, Gs^Fp, Gs^Fp, Gs^Fp, Hh^Fms, Hh^Fp, Mm, Hh^Fds, Hh^Fds, Mm^Xm, Mm^Xm, Mm^Xm
Hh, Hh, Hh, Hh, Hh, Gs^Fp, Gg, Ce, Ce, Ce, Gg, Gs, Re, Gg, Re, Gg, Gs, Gg^Vh, Gs, Gs^Fp, Gs, Gs, Re, Gg, Gg, Gg, Gs^Fp, Gs^Fp, Gs^Fds, Hh^Fds, Hh^Fp, Hh^Fp, Gs^Fds, Md, Mm, Mm, Mm
Gs^Fds, Hh, Hh, Hh, Hh, Gg, Gg, Gg, Gg, Gg, Gg, Gg^Vh, Gg, Re, Hh, Re, Re, Gs, Gs, Gs, Gg, Gs, Gg, Re, Re, Gg, Gg, Gs, Gs, Gs^Fds, Hh, Hh, Hh, Gs^Fds, Hh^Fds, Hh^Fds, Hh^Fds
Gs^Fds, Gs^Fds, Hhd^Fmf, Hh, Hh, Hh, Hh, Gg, Hh, Gg, Hh, Gg, Hh, Hh, Hh, Hh, Hh, Gg, Gg, Gg, Hh, Hh, Hh, Gg, Re, Re, Gg, Gg, Hh, Hh, Hh, Hh, Hh, Gs^Fp, Gs^Fp, Hh^Fds, Hh^Fds
Md, Hhd^Fmf, Hhd^Fmf, Gs^Fds, Hh, Hh, Hh, Hh, Hh, Hh, Hh, Hh, Hh, Hh, Hh, Hh, Hh, Hh, Hh, Hh, Hh, Hh, Hh, Hh, Hh, Re, Re, Gg, Gs^Fp, Hh, Hh, Hh, Hh, Hh, Hh, Gs^Fp, Gs^Fp
Mm^Xm, Md, Hhd, Gll^Fmf, Gs^Fds, Hh, Hh, Hh, Hh, Hh, Hh, Hh, Hh, Hh, Hh, Hh, Hh, Hh, Hh, Hh, Hh, Hh, Hh, Hh, Hh, Gg^Vh, Gg, Gs, Gs^Fp, Hh, Hh, Hh, Hh, Hh, Gs^Fp, Gs^Fp, Gs^Fp
Mm^Xm, Md, Md, Hhd, Gd^Fdf, Gd^Fdf, Gs^Fds, Gs^Fds, Hhd^Fdf, Gd^Fdf, Hhd^Fdf, Hh, Hh, Hh, Hh, Hh, Hh, Hh, Hh, Hh, Hh, Hh, Hh, Hh, Gs, Gg, Gg, Gs, Gs^Fp, Gs^Fp, Gs^Fp, Gs^Fp, Hh, Hh, Hh, Gs^Fp, Gs^Fp
Mm, Md^Xm, Mm^Xm, Hhd, Gd^Fdf, Gd^Fdf, Gd^Fdf, Hhd^Fdf, Mm, Md, Md, Gs^Fds, Hh^Fds, Gs^Fds, Hh^Fp, Hh, Gs^Fds, Hh, Hh, Hh, Hh, Hh, Hh, Hh, Gs, Gg, Re, Gs, Gs, Gs^Fp, Gs^Fp, Hh, Hh, Hh, Hh, Hh, Gs^Fp
Mm^Xm, Mm^Xm, Mm^Xm, Md, Mm^Xm, Mm, Mm^Xm, Mm, Mm^Xm, Mm^Xm, Mm^Xm, Mm, Mm, Mm, Mm, Hh^Fp, Hh^Fds, Hh, Hh, Hh, Hh, Hh, Hh, Gs, Gg, Gg, Gg, Re, Gg, Gs^Fp, Hh, Hh, Gs, Hh, Hh, Hh, Hh
Mm^Xm, Mm^Xm, Mm^Xm, Mm^Xm, Mm^Xm, Mm^Xm, Md, Mm^Xm, Mm^Xm, Mm^Xm, Mm^Xm, Mm^Xm, Mm^Xm, Mm^Xm, Mm, Hhd, Hh^Fp, Hh, Hh, Hh, Hh, Hh, Gs, Gs, Gg, Gg, Re, Re, Gg, Gg, Gg, Gg, Gg^Vh, Gs, Hh, Hh, Hh
Mm^Xm, Md, Md, Mm^Xm, Mm^Xm, Mm^Xm, Mm^Xm, Md, Mm^Xm, Md, Md, Md, Md, Mm, Gs^Fp, Gs^Fp, Hh, Hh, Hh, Hh, Hh, Hh, Gs, Gs, Gs, Re, Gs^Fp, Gg, Gg, Gg, Gg, Gg, Gs^Fp, Gs^Fp, Gs^Fp, Hh, Gd^Fdf
Mm^Xm, Md, Md, Md, Mm^Xm, Mm^Xm, Mm^Xm, Mm^Xm, Mm, Mm, Md, Md, Gs^Fp, Gs^Fp, Hh, Hh, Hh, Hh, Hh, Hh, Hh, Hh, Gs, Gs, Gs, Gs^Fp, Gs^Fp, Gs, Gs, Gg, Chr, Gs^Fp, Gs^Fp, Gs^Fp, Gs^Fp, Gd^Fdf, Gd^Fdf
Mm^Xm, Mm^Xm, Mm^Xm, Mm^Xm, Md, Mm, Hhd^Fdf, Mm, Hhd, Hhd, Hhd, Hhd, Hhd^Fmf, Gs^Fp, Hh, Hh^Vhh, Hh, Hh, Gg, Gs, Re, Re, Re, Re, Hh, Hh, Hh, Hh, Hh^Vhh, Chr, Chr, Chr, Gs^Fp, Gs^Fp, Gd^Fdf, Gd^Fdf, Mm
Mm^Xm, Mm^Xm, Md, Md, Md, Hhd^Fdf, Gd^Fdf, Gd^Fdf, Hh, Hh, Hh, Gd^Fdf, Hh^Fp, Hh^Fp, Hh, Hh, Gg, Gg, Re, Re, Hh, Hh, Hh, Hh, Hh, Hh, Hh, Hh, Hh, Chr, Chr, 2 Khr, Gs^Fp, Gs^Fp, Hh, Hh, Mm
Md, Mm^Xm, Md, Md, Hhd, Hhd, Hh, Hh, Hh, Hh, Hh, Gs^Fp, Gs^Fp, Hh, Hh, Gg, Gs, Re, Gs, Gs, Hh, Hh, Hh, Hh, Hh, Hh, Gs^Fp, Hh, Hh, Hh, Hh, Hh, Hh, Hh, Hh, Mm, Mm^Xm
Hhd, Md, Hhd, Hhd, Hh, Hhd, Hh, Hh, Gs^Fp, Hh, Gs^Fp, Gs^Fp, Gs^Fp, Gs^Fp, Gs, Gs, Gg, Gg, Gs, Gg, Gg, Hh, Hh, Hh, Hh, Gs^Fp, Gs^Fp, Gs^Fp, Hhd^Fdf, Hhd^Fmf, Hhd^Fmf, Hh, Gs^Fds, Hh, Hh^Fds, Mm, Mm^Xm
Hhd^Fmf, Hhd, Hh^Fp, Hh, Hh, Hh, Hh, Gll^Fmf, Gs^Fds, Gs^Fp, Gg, Gs^Fp, Re, Re, Gs^Fp, Gg, Gg, Gs, Hh, Gg, Hh, Hh, Hh, Hh, Gs^Fp, Gs^Fp, Gs^Fp, Hhd^Fdf, Mm, Mm, Mm^Xm, Gs^Fds, Md, Hh^Fds, Md, Md, Mm^Xm
Gd^Fdf, Hh^Fp, Gs^Fp, Hh, Hh, Hh, Hh, Gs^Fds, Gll^Fmf, Gg, Gs, Re, Gs, Gs^Fp, Gg, Gg, Gg, Gg, Hh, Hh, Hh, Hh, Gs^Fp, Gs^Fp, Gll^Fmf, Gs^Fp, Mm, Mm, Mm^Xm, Mm^Xm, Mm^Xm, Mm^Xm, Mm^Xm, Md, Md^Xm, Md^Xm, Mm^Xm
Gs^Fds, Gs^Fds, Gs^Fds, Gs^Fp, Hh, Hh, Hh, Gs^Fds, Gg, Gg, Re, Gs, Gg, Gg, Gg, Gs^Vh, Gg, Hh, Hh, Hh, Hh, Hh, Gs^Fp, Gll^Fmf, Md, Md, Mm^Xm, Mm^Xm, Mm^Xm, Mm^Xm, Mm^Xm, Mm^Xm, Mm^Xm, Mm^Xm, Mm^Xm, Md^Xm, Mm^Xm
Gs^Fds, Gs^Fds, Gs^Fp, Gs^Fp, Hh, Hh, Hh, Gg, Gg, Gg, Gs, Gg, Gg, Gg, Gg, Gg, Hh, Hh, Hh, Hh, Hh, Gs^Fp, Gs^Fp, Gd^Fdf, Md, Md, Md, Mm^Xm, Mm, Mm^Xm, Mm^Xm, Mm, Mm, Mm, Mm, Mm^Xm, Mm^Xm
Gs^Fp, Gs^Fp, Gs^Fp, Hh, Hh, Hh, Hh, Gg, Gs^Fp, Gg, Gs, Gg, Gg, Gg, Gg, Gg, Gg, Hh, Hh, Hh, Hh, Hh, Hh, Gd^Fdf, Gd^Fdf, Md, Md, Md, Mm, Mm^Xm, Md^Xm, Mm^Xm, Mm, Mm, Mm, Mm, Mm^Xm
Hh^Fp, Gs^Fp, Hh, Hh, Hh, Hh, Hh, Gg, Gg, Gg^Vh, Gg, Re, Re, Gg, Gg, Gg, Gg, Gg, Gg, Hh, Hh, Hh, Hh, Hh, Hhd^Fdf, Hhd^Fmf, Hhd^Fmf, Mm, Mm, Mm^Xm, Mm^Xm, Mm^Xm, Mm^Xm, Mm, Mm^Xm, Mm, Mm
Hh, Hh, Hh, Hh, Hh, Hh, Hh, Hh, Hh, Gg, Gg, Gg, Gg, Gs, Gs, Gg, Gg, Gg, Gg, Hh, Hh, Hh, Hh, Hh, Hh, Hhd^Fmf, Gd^Fdf, Hhd^Fdf, Hhd^Fdf, Mm, Mm, Mm, Mm, Mm^Xm, Mm^Xm, Mm, Mm
Hh, Hh, Hh, Hh, Hh, Hh, Hh, Hh, Hh, Hh, Hh, Gg, Gg, Gg, Gg, Re, Re, Re, Gg^Vh, Hh, Gs^Fp, Hh, Hh, Hh, Hh, Gd^Fdf, Hh, Gd^Fdf, Gs^Fp, Gll^Fmf, Gll^Fmf, Md, Md, Mm^Xm, Mm^Xm, Md^Xm, Mm^Xm
Gd^Fdf, Hh, Hh, Hh, Hh, Hh, Hh, Hh, Hh, Hh, Hh, Chr, Chr, Gg, Gg, Gs^Fp, Gg, Re, Gs, Gs^Fp, Gs^Fp, Gs^Fp, Gs^Fp, Hh, Hh, Hh, Hh, Hh, Hh, Gs^Fp, Gs^Fp, Gll^Fmf, Md, Md, Mm^Xm, Mm, Mm^Xm
Gd^Fdf, Gd^Fdf, Gd^Fdf, Gd^Fdf, Gs^Fds, Hh, Hh, Hh, Hh, Hh, Hh, 3 Khr, Chr, Chr, Gs^Fp, Gs^Fp, Gs^Fp, Gg, Gg, Re, Re, Gg, Gg, Gg, Hh, Hh, Hh, Hh, Gs^Fp, Gs^Fp, Gs^Fp, Gll^Fmf, Hhd, Md, Md, Md^Xm, Mm^Xm
Mm, Gd^Fdf, Mm, Gd^Fdf, Gs^Fds, Gs^Fds, Gs^Fds, Hh^Fp, Gs^Fp, Hh, Hh, Hh, Hh, Hh, Hh, Gs^Fp, Gs^Fp, Gs^Fp, Gg, Re, Re, Gg, Gg, Hh, Hh, Hh, Hh, Hh, Hh, Hh, Hh, Gs^Fp, Hhd, Md, Md, Mm^Xm, Mm^Xm
Mm^Xm, Mm, Mm^Xm, Mm, Mm, Gd^Fdf, Gd^Fdf, Hh^Fp, Hh^Fp, Gs^Fp, Gs^Fp, Hh^Fp, Hh, Hh, Hh, Hh, Hh, Gg, Gg, Gg, Re, Re, Re, Hh, Hh, Hh, Hh, Hh, Hh, Hh, Gs^Fp, Gs^Fp, Gs^Fp, Gll^Fmf, Gll^Fmf, Md, Md
Mm^Xm, Mm^Xm, Mm^Xm, Hh, Mm, Mm, Gd^Fdf, Hhd^Fmf, Hh^Fp, Hh^Fp, Gs^Fp, Gs^Fds, Gll^Fmf, Hh, Hh, Hh, Hh, Hh, Hh, Gg, Gg, Re, Re, Re, Hh, Hh, Gg, Hh, Hh, Hh, Gs^Fp, Gs^Fp, Gs^Fp, Gs^Fp, Gll^Fmf, Gd^Fdf, Gd^Fdf
Mm^Xm, Mm^Xm, Mm^Xm, Mm^Xm, Mm, Gd^Fdf, Gd^Fdf, Hhd^Fmf, Hhd^Fmf, Hhd^Fmf, Mm, Gs^Fds, Gs^Fds, Gs^Fp, Gs^Fp, Gs^Fp, Gs^Fp, Hh, Hh, Hh, Hh, Gg, Gg, Re, Re, Gg, Gg, Gg, Hh, Hh, Hh, Gs^Fp, Gs^Fds, Gs^Fp, Gs^Fds, Gs^Fds, Gs^Fds
Mm, Mm, Mm^Xm, Mm^Xm, Mm^Xm, Mm, Mm, Mm, Mm^Xm, Mm^Xm, Mm^Xm, Mm, Mm, Hhd, Hhd, Gd^Fdf, Gd^Fdf, Hh, Hh, Hh, Hh, Hh, Gs^Fp, Re, Re, Gg, Gs^Vh, Gg, Hh, Hh, Hh, Gs^Fp, Gs^Fds, Gs^Fds, Hhd^Fdf, Gs^Fds, Gs^Fds
Mm^Xm, Mm, Mm, Mm^Xm, Mm^Xm, Mm, Mm, Mm, Mm^Xm, Mm^Xm, Mm^Xm, Mm^Xm, Mm^Xm, Hhd, Md, Hhd, Gs^Fp, Hh, Hh, Hh, Hh, Hh, Gs^Fp, Gs^Fp, Re, Re, Gg, Gg, Hh, Hh, Hh, Hh, Hhd^Fdf, Hhd^Fdf, Hhd^Fdf, Hhd^Fdf, Gs^Fds
Mm^Xm, Mm^Xm, Mm^Xm, Mm, Mm^Xm, Mm^Xm, Mm^Xm, Mm^Xm, Mm, Mm^Xm, Mm^Xm, Mm^Xm, Mm^Xm, Mm^Xm, Md, Mm, Mm, Gs^Fp, Hh, Hh, Hh, Gs^Fp, Gs^Fp, Gs^Fp, Re, Gg, Hh, Hh, Hh, Hh, Hh, Hh, Hhd^Fdf, Mm, Mm, Hhd^Fdf, Hhd^Fdf
Mm^Xm, Mm^Xm, Mm^Xm, Mm^Xm, Mm^Xm, Mm^Xm, Mm^Xm, Mm^Xm, Mm^Xm, Mm^Xm, Mm^Xm, Mm^Xm, Mm^Xm, Md, Md, Mm, Gs^Fp, Gs^Fp, Gs^Fp, Hh, Hh, Gs^Fp, Gs^Fp, Gg, Gs, Gg, Hh, Hh, Hh, Hh, Hh, Hh, Mm, Md, Md, Mm, Mm
Gs^Fds, Mm^Xm, Mm, Mm^Xm, Mm, Mm, Mm, Mm^Xm, Md, Mm^Xm, Md, Md, Md, Md, Mm, Hhd, Gs^Fp, Gs^Fp, Gs^Fp, Hh, Hh, Gs^Fp, Gs^Fp, Gg, Re, Gg, Hh, Hh, Hh, Hh, Hh, Hhd^Fdf, Hhd^Fdf, Mm, Mm, Md, Mm^Xm
Gs^Fds, Hhd^Fmf, Hhd, Hhd, Hhd, Mm, Hhd^Fdf, Md, Hhd, Md, Hhd^Fdf, Hhd^Fmf, Hhd, Md, Hhd^Fmf, Gs^Fp, Gs^Fp, Hh, Hh, Hh, Gg, Gs^Fp, Gg, Gg, Re, Hh, Hh, Hh, Hh, Hh, Hh, Hh^Fp, Hh^Fp, Mm, Mm^Xm, Mm^Xm, Mm^Xm
Gs^Fds, Gs^Fds, Hhd^Fmf, Hh, Hh, Hhd^Fdf, Hh, Hhd, Hh, Hhd, Hhd^Fdf, Hhd^Fdf, Hh, Hhd, Hh, Gd^Fdf, Hh, Hh, Hh, Hh, Gg, Gg, Gg, Re, Re, Hh, Chr, Chr, Hh, Hh, Hh, Hh^Fp, Md, Md, Mm^Xm, Md, Mm^Xm
Gs^Fds, Gs^Fds, Hh, Hh, Hh, Hh, Hh, Hh, Hh, Hh, Hh, Hh, Hh, Hh, Hh, Hh, Hh, Hh, Hh, Hh, Gg, Gs^Vh, Gg, Re, Re, Gg, Chr, 4 Khr, Chr, Hh, Hh, Gd^Fdf, Gd^Fdf, Md, Mm^Xm, Mm^Xm, Mm^Xm
Gs^Fds, Gs^Fds, Re, Hh, Re, Re, Re, Hh, Re, Hh, Hh, Hh, Hh, Hh, Hh, Hh, Hh, Hh, Hh, Hh, Gg, Gg, Gs^Fp, Gg, Gs, Gg, Gg, Chr, Chr, Hh, Hh, Hh, Hhd^Fdf, Mm, Md, Mm^Xm, Mm^Xm
Re, Re, Ww, Re, Ww, Re, Re, Re, Re, Re, Re, Hh, Hh, Hh, Gs, Hh, Hh, Hh, Hh, Hh, Gs^Fp, Gs^Fp, Gg^Fet, Gs^Fp, Gs^Fp, Gs, Re, Gg, Gg, Gg^Vh, Gg, Hh, Hhd^Fdf, Mm, Mm, Mm^Xm, Mm^Xm
Ww, Ww, Wo, Ww, Ww, Ww^Vm, Ww, Ww, Ww, Re, Re, Re, Re, Re, Gs, Gs, Gs, Gs, Gs^Fp, Gs^Fp, Gs^Fp, Gs^Fp, Gs^Fp, Gs^Fp, Gs^Fp, Gs^Fp, Gs^Fp, Re, Re, Gg, Gg, Hh, Hh, Hhd^Fdf, Hh^Fds, Mm, Mm
Wo, Wo, Wo, Wo, Wo, Ww, Ww, Ww, Ww, Ww, Ww, Ww, Ww, Re, Re, Gs, Re, Gs, Gs^Fp, Gs^Fp, Gs^Fp, Gs^Fp, Gs^Fp, Gs^Fp, Gd, Gd, Gg^Vh, Gg, Re, Gg, Gg, Hh, Hh, Hh, Hh^Fds, Hh^Fds, Hhd^Fdf
Wo, Wo, Wo, Wo, Ww, Ww, Wo, Ww, Wo, Ww, Ww, Ww, Ww, Wwrg, Wwrg, Re, Re, Re, Re, Gs, Gs, Gs, Gs, Gd, Gg, Gg, Gg, Gg, Gg, Re, Gg, Hh, Hh, Hh, Gs^Fds, Hh^Fds, Hhd^Fdf
Wo, Wo, Wo, Wo, Wo, Wo, Wo, Wo, Wo, Wo, Wo, Wo, Wo, Wwr, Wwr, Re, Ww, Re, Re, Re, Re, Re, Re, Gs, Gs, Gg, Gg, Gg, Gs, Re, Gg, Hh, Hh, Hh, Hh, Gs^Fds, Gs^Fds
Wo, Wo, Wo, Wo, Wo, Wo, Wo, Wo, Wo, Wo, Wo, Wo, Wo, Wo, Wo, Ww, Ww, Ww, Ww, Ww, Ww, Ww, Ww, Re, Re, Gs, Gs, Gs, Rp, Rp, Gs, Gg, Gs, Hh, Hh, Gs^Fds, Gs^Fp
Wo, Wo, Wo, Wo, Wo, Wo, Wo, Wo, Wo, Wo, Wo, Wo, Wo, Wo, Wo, Wo, Wo, Wo, Wo, Ww, Wo, Ww, Ww, Re, Ww, Re, Re, Gs, Rp, Rp, Gs^Vh, Gd, Gs, Gs, Hh, Hh, Gs^Fp
Ww, Wo, Wo, Wo, Wo, Wo, Wo, Wo, Wo, Wo, Ww, Wo, Wo, Wo, Wo, Wo, Ww, Ww, Ww, Wo, Ww, Wo, Wo, Ww, Ww, Wwf, Wwf, Rp, Rp, Rp, Gs, Gd, Gs^Fp, Gs^Fp, Gs^Fp, Gs^Fp, Gs^Fp
Re, Ww, Ww, Ww, Ww, Wo, Wo, Wo, Wo, Ww, Ww, Wo, Wo, Wo, Wo, Ww, Ww, Ww, Chw, Ww, Ww, Wo, Ww, Ww, Ww, Ww, Ww^Bw/, Ww^Bw/, Ww, Re, Re, Gs, Gs^Fp, Gs^Fp, Gs^Fp, Gs^Fp, Gs^Fp
Re, Wwrg, Re, Wwrg, Ch, Ww, Ww, Ww, Ww, Ww, Ww, Ww, Ww, Wo, Ww, Ww, Ww, Gg^Vh, 5 Khw, Chw, Ww, Ww, Ww, Ww, Ww^Bw/, Ww^Bw/, Ww, Ww, Wo, Ww, Ww, Re, Gs^Fms, Gs^Fp, Gs^Fp, Gs^Fp, Gs^Fp
Gs, Re, Gs, Re, Gs, Re, Re, Ch, Re, Wwrg, Ch, Ww, Ww, Ww, Ww, Ww, Ww^Bw/, Gg, Chw, Chw, Ww, Ww, Ww^Bw/, Ww^Bw/, Ww, Ww, Ww, Ww, Wo, Ww, Ww, Re, Re, Re, Re, Gs^Fp, Gs^Fp
Gs, Gs, Gs^Fp, Gs, Gs^Fp, Gs, Gs, Re, Gs, Re, Gs, Re, Ch, Ww, Ww^Bw/, Ww^Bw/, Ww, Ww, Ww, Ww, Ww^Bw/, Ww^Bw/, Ww, Ww, Ww, Ww, Wo, Wo, Wo, Wo, Wo, Ww, Ww, Wwrg, Ww, Re, Re
Gs^Fp, Gs^Fp, Gs^Fp, Gs^Fp, Gs^Fp, Gs^Fp, Gs^Fp, Gs, Gs, Gs^Wm, Gg, Gs, Rp, Rp, Ch, Ww, Wwf, Wwf, Ww^Bw/, Ww^Bw/, Ww, Ww, Ww, Ww, Wo, Wo, Wo, Wo, Wo, Wo, Wo, Wo, Wo, Ww, Wo, Ww, Ww
Gs^Fp, Gs^Fp, Gs^Fp, Gs^Fp, Gs^Fp, Gs^Fp, Gs^Fp, Gs^Fp, Gs, Gs, Gg, Gg, Gg, Gg, Gg, Ch, Rp, Rp, Rp, Wwf, Ww, Ww, Ww, Wo, Wo, Wo, Wo, Wo, Wo, Wo, Wo, Wo, Wo, Wo, Wo, Wo, Ww
Gs^Fp, Gs^Fp, Gs^Fp, Gs^Fp, Gs^Fp, Gs^Fp, Gs^Fp, Gs^Fp, Gs, Gs, Gg, Gg, Gg, Gg, Gg^Wm, Gg, Rp, Rp, Rp, Ch, Re, Ch, Wwrg, Ww, Ww, Wo, Wo, Wo, Wo, Wo, Wo, Wo, Wo, Wo, Wo, Wo, Ww
Gs^Fp, Gs^Fp, Gs^Fp, Gg^Fet, Gs^Fp, Gs^Fp, Gs^Fp, Gs^Fp, Gs, Gg, Gg, Gg, Gg, Gg, Gg, Gg, Rp, Rp, Rp, Rr^Vhc, Re, Re, Re, Ww, Ww, Ww, Ww, Wo, Wo, Wo, Wo, Wo, Wo, Wo, Wo, Wo, Wo
Gs^Fp, Gs^Fp, Gs^Fp, Gs^Fp, Gs^Fp, Gs^Fp, Gs^Fp, Gs^Fp, Gs, Gs, Gg, Gg, Rp, Ch, Rp, Rp, Rp, Rp, Gg, Gs, Gs^Wm, Gs, Gs, Ch, Re, Ww, Wwrg, Ww, Ww, Ww, Ww, Wo, Wo, Wo, Wo, Wo, Wo
Gs^Fp, Gs^Fp, Gs^Fp, Gs^Fp, Gs^Fp, Gs^Fp, Gs^Fp, Gs, Gs, Gg, Gg, Gg^Vh, Rp, Rp, Rp, Rp, Gg, Gg, Gg, Gg, Gs, Gs, Gs, Gs, Gs, Ch, Re, Re, Ch, Ww, Ww, Wo, Wo, Wo, Wo, Wo, Wo
Gs^Fp, Gs^Fp, Gs^Fp, Gs^Fp, Gs^Fp, Gs^Fp, Gs, Gs, Gg, Gg, Rp, Rp, Rp, Rp, Gg, Gg, Gg, Gg, Gs, Gs, Gs^Fp, Gs^Fp, Gs^Fp, Gs, Gs, Gs, Gs, Re, Gs, Ch, Re, Ww, Ww, Wo, Ww, Wo, Wo
Gs^Fp, Gs^Fp, Gs^Fp, Gs^Fp, Gs, Gs, Gg, Gg, Rp, Rp, Rp, Rp, Rp, Gg, Gg, Gg, Gg, Gg, Gs, Gs^Fp, Gs^Fp, Gs^Fp, Gs^Fp, Gs^Fp, Gs, Gs, Gs, Gs, Gs, Gs, Re, Re, Re, Ww, Ww, Ww, Ww
