border_size=1
usage=map

Gs^Fds, Gs^Fds, Gd^Fdf, Hhd^Fdf, Gd^Fdf, Hh, Gs^Fds, Gg, Gs, Gs, Rd, Gs, Gs^Fds, Gs^Fds, Gs^Fds, Hhd^Fmf, Gd^Fdf, Gd^Fdf, Gd^Fdf, Gd^Fdf, Gs^Fds, Gs^Fds, Hh, Hh, Hh, Gs^Fds, Hhd^Fdf, Hhd^Fdf, Hhd^Fdf, Mm, Mm^Xm, Mm^Xm, Mm^Xm, Mm^Xm, Mm^Xm, Mm^Xm, Mm^Xm
Gs^Fds, Gs^Fds, Gll^Fmf, Gd^Fdf, Hh^Fds, Hh^Fds, Gs^Fds, Gs^Fds, Gg, Gs, Rd, Rd, Gs, Gg, Gll^Fp, Hhd^Fmf, Hhd^Fmf, Gd^Fdf, Hhd^Fmf, Gd^Fdf, Hh, Hh, Hh, Hh, Gll^Fp, Gs^Fds, Gll^Fp, Gll^Fp, Hhd^Fdf, Mm, Mm, Mm^Xm, Mm^Xm, Mm^Xm, Mm^Xm, Mm^Xm, Mm^Xm
Gd^Fdf, Gll^Fmf, Gll^Fmf, Hhd^Fdf, Gs^Fp, Hh^Fds, Gg, Gg, Ce, Gg^Vh, Gg, Rd, Gg, Gll^Fp, Gll^Fp, Gll^Fp, Gll^Fp, Hhd^Fmf, Gll^Fp, Gll^Fp, Hh, Hh, Hh, Hh, Hh, Gll^Fp, Hh, Gll^Fp, Gll^Fp, Mm, Hh^Fms, Mm, Mm, Mm^Xm, Md, Mm^Xm, Mm^Xm
Hh, Hhd^Fdf, Hh, Hh^Fp, Hh^Fp, Gs^Fp, Gg, Ce, 1 Ke, Ce, Gg, Gs, Gg, Gg, Gg, Gg, Gg, Gs^Fp, Gs^Fp, Gs^Fp, Gs^Fp, Gg, Gg, Gg, Gg, Hh, Gll^Fp, Gll^Fp, Gll^Fp, Hh^Fms, Hh^Fp, Mm, Hh^Fds, Hh^Fds, Mm^Xm, Mm^Xm, Mm^Xm
Hh, Hh, Hh, Hh, Hh, Gs^Fp, Gg, Ce, Ce, Ce, Gg, Gs, Rd, Gg, Rd, Gs, Gs, Gg^Vh, Gs, Gs^Fp, Gs, Gs, Rd, Gg, Gg, Gg, Gll^Fp, Gll^Fp, Gs^Fds, Hh^Fds, Hh^Fp, Hh^Fp, Gs^Fds, Md, Mm, Mm, Mm
Gs^Fds, Hh, Hh, Hh, Hh, Gs, Gg, Gg, Gg, Gg, Gg, Gg^Vh, Gg, Rd, Gs^Fp, Rd, Gs, Gs, Gs, Gs, Gg, Gs, Gg, Rd, Rd, Gg, Gg, Gg, Gg, Gs^Fds, Hh, Hh, Hh, Gs^Fds, Hh^Fds, Hh^Fds, Hh^Fds
Gs^Fds, Gs^Fds, Hhd^Fmf, Hh, Hh, Hh, Hh, Gs, Gs, Gg, Hh, Gs, Hh, Gs^Fp, Gs^Fp, Gs^Fp, Gs^Fp, Gg, Gll^Fp, Gg, Gll^Fp, Gll^Fp, Gll^Fp, Gg, Rd, Rd, Gg, Gg, Gg, Gg, Gs, Hh, Hh, Gll^Fp, Gll^Fp, Hh^Fds, Hh^Fds
Md, Hhd^Fmf, Hhd^Fmf, Gs^Fds, Hh, Hh, Hh, Hh, Hh, Hh, Hh, Hh, Hh, Hh, Hh, Gs^Fp, Gll^Fp, Gs^Fp, Gs^Fp, Gs^Fp, Gs^Fds, Gs^Fds, Hh^Fp, Gg, Gg, Rd, Rd, Gg, Gg, Gg, Gg, Hh, Hh, Hh, Hh, Gll^Fp, Gll^Fp
Mm^Xm, Md, Hhd, Gll^Fmf, Gs^Fds, Hh, Hh, Hh, Hh, Hh, Hh, Hh, Hh, Hh, Hh, Hh, Hh, Hh, Hh, Hh^Fp, Hh, Hh, Hh, Gs^Fds, Gs^Fds, Gg^Vh, Gg, Rd, Rd, Gg, Gg, Gs^Efm, Gs^Fp, Hh, Gll^Fp, Gll^Fp, Gll^Fp
Mm^Xm, Md, Md, Hhd, Gd^Fdf, Gd^Fdf, Gs^Fds, Gs^Fds, Hhd^Fdf, Gd^Fdf, Hhd^Fdf, Hh, Hh, Hh, Hh, Hh, Hh, Hh, Hh, Hh, Hh, Hh, Hh, Hh^Fp, Gs^Fds, Gg, Gg, Gs, Rd, Gs, Gg, Gs^Fp, Gs^Fp, Hh, Hh, Gll^Fp, Gll^Fp
Mm, Md^Xm, Mm^Xm, Hhd, Gd^Fdf, Gd^Fdf, Gd^Fdf, Hhd^Fdf, Mm, Md, Md, Gs^Fds, Hh^Fds, Gs^Fds, Hh^Fp, Hh, Gs^Fds, Hh, Hh, Hh, Hh, Hh, Hh^Fp, Hh^Fp, Gs^Fds, Gg, Gg, Rd, Rd, Gs, Gg, Gg, Gg, Gs^Fp, Hh, Hh, Gll^Fp
Mm^Xm, Mm^Xm, Mm^Xm, Md, Mm^Xm, Mm, Mm^Xm, Mm, Mm^Xm, Mm^Xm, Mm^Xm, Mm, Mm, Mm, Mm, Hh^Fp, Hh^Fds, Hh, Hh, Hh, Hh, Hh, Gll^Fmf, Gs^Fds, Gg, Gg, Gs, Rd, Gg, Gg, Gg, Gg, Gg, Gs^Fp, Hh, Hh, Hh
Mm^Xm, Mm^Xm, Mm^Xm, Mm^Xm, Mm^Xm, Mm^Xm, Md, Mm^Xm, Mm^Xm, Mm^Xm, Mm^Xm, Mm^Xm, Mm^Xm, Mm^Xm, Mm, Hhd, Hh^Fp, Hh, Hh, Hh, Hh, Hh, Gll^Fmf, Gll^Fmf, Gg, Gg, Rd, Rd, Gg, Gg, Gg, Gg, Gg^Vh, Gs^Fp, Hh, Hh, Hh
Mm^Xm, Md, Md, Mm^Xm, Mm^Xm, Mm^Xm, Mm^Xm, Md, Mm^Xm, Md, Md, Md, Md, Mm, Gs^Fds, Hh^Fp, Hh, Hh, Hh, Hh, Hh, Hh, Gll^Fp, Gg, Gg, Gg, Gs, Gg, Gg, Gg, Gll^Fp, Gll^Fp, Gll^Fp, Gs^Fp, Gll^Fp, Hh, Gd^Fdf
Mm^Xm, Md, Md, Md, Mm^Xm, Mm^Xm, Mm^Xm, Mm^Xm, Mm, Mm, Md, Md, Hh^Fds, Gs^Fds, Hh^Fp, Gs^Fds, Hh, Hh, Gs^Fp, Gs^Fp, Gs^Fp, Gll^Fp, Gs, Gg, Gs, Gs, Gs, Gg, Gg, Gg, Chr, Gll^Fp, Gll^Fp, Gll^Fp, Gll^Fp, Gd^Fdf, Gd^Fdf
Mm^Xm, Mm^Xm, Mm^Xm, Mm^Xm, Md, Mm, Hhd^Fdf, Mm, Hhd, Hhd, Hhd, Hhd, Hhd^Fmf, Hh^Fp, Hh^Fp, Hh^Vhh, Hh, Hh^Fp, Gg, Gs^Fp, Rd, Rd, Rd, Rd, Gs^Fp, Gs^Fp, Gs^Fp, Gg, Gg^Vh, Chr, Chr, Chr, Gll^Fp, Gll^Fp, Gd^Fdf, Gd^Fdf, Mm
Mm^Xm, Mm^Xm, Md, Md, Md, Hhd^Fdf, Gd^Fdf, Gd^Fdf, Hh, Hh, Hh, Gd^Fdf, Hh^Fp, Hh^Fp, Gs^Fds, Hh, Gg, Gg, Rd, Rd, Gs^Fp, Gs^Fp, Gs^Fp, Gs^Fp, Hh, Gs^Fp, Hh, Gs, Hh, Chr, Chr, 2 Khr, Gll^Fp, Gll^Fp, Gs^Fds, Gs^Fds, Mm
Md, Mm^Xm, Md, Md, Hhd, Hhd, Hh, Hh, Hh, Hh, Hh, Gs^Fp, Gs^Fp, Gs^Fds, Gs^Fds, Gg, Gs, Rd, Gs, Gs, Gg^Efm, Gs^Fp, Hh, Hh, Hh, Hh, Gll^Fp, Hh, Hh, Hh, Hh, Hh, Hh^Fp, Hh^Fp, Hh^Fds, Mm, Mm^Xm
Hhd, Md, Hhd, Hhd, Hh, Hhd, Hh, Hh, Gs^Fp, Hh, Gs^Fp, Gll^Fp, Gs^Fp, Gs^Fp, Gs, Gs, Gg, Gg, Gs, Gg, Gg, Hh, Hh, Hh, Hh, Gll^Fp, Gll^Fp, Gll^Fp, Hhd^Fdf, Hhd^Fmf, Hhd^Fmf, Gs^Fds, Gs^Fds, Gs^Fds, Hh^Fds, Mm, Mm^Xm
Hhd^Fmf, Hhd, Hh^Fp, Hh, Hh, Hh, Hh, Gll^Fmf, Gs^Fds, Gs^Fp, Gg, Gs^Fp, Rd, Rd, Gs^Fp, Gg, Gg, Gs, Hh, Gg, Hh, Hh, Hh, Hh, Gll^Fp, Gll^Fp, Gll^Fp, Hhd^Fdf, Mm, Mm, Mm^Xm, Gs^Fds, Md, Hh^Fds, Md, Md, Mm^Xm
Gd^Fdf, Hh^Fp, Gll^Fp, Hh, Hh, Hh, Hh, Gs^Fds, Gll^Fmf, Gg, Gs, Rd, Gs, Gs^Fp, Gg, Gg, Gg, Gg^Vh, Hh, Hh, Hh, Hh, Gll^Fp, Gll^Fp, Gll^Fmf, Gll^Fp, Mm, Mm, Mm^Xm, Mm^Xm, Mm^Xm, Mm^Xm, Mm^Xm, Md, Md^Xm, Md^Xm, Mm^Xm
Gs^Fds, Gs^Fds, Gs^Fds, Gll^Fp, Hh, Hh, Hh, Gs^Fds, Gg^Efm, Gg, Rd, Gs, Gg, Gg, Gg, Gg, Gs, Hh, Hh, Hh, Hh, Hh, Gll^Fp, Gll^Fmf, Md, Md, Mm^Xm, Mm^Xm, Mm^Xm, Mm^Xm, Mm^Xm, Mm^Xm, Mm^Xm, Mm^Xm, Mm^Xm, Md^Xm, Mm^Xm
Gs^Fds, Gs^Fds, Gll^Fp, Gll^Fp, Hh, Hh, Hh, Gg, Gg, Gg, Gs, Gg, Gg, Gg, Gg, Gs, Hh, Hh, Hh, Hh, Hh, Gll^Fp, Gll^Fp, Gd^Fdf, Md, Md, Md, Mm^Xm, Mm, Mm^Xm, Mm^Xm, Mm, Mm, Mm, Mm, Mm^Xm, Mm^Xm
Gll^Fp, Gll^Fp, Gll^Fp, Hh, Hh, Hh, Hh, Gd, Gs^Fp, Gg, Gs, Gg, Gg, Gg, Gg, Gs, Gs, Hh, Hh, Hh, Hh, Hh, Hh, Gd^Fdf, Gd^Fdf, Md, Md, Md, Mm, Mm^Xm, Md^Xm, Mm^Xm, Mm, Mm, Mm, Mm, Mm^Xm
Hh^Fp, Gll^Fp, Hh, Hh, Hh, Hh, Hh, Hh^Fp, Gs^Fp, Gg^Vh, Gd, Rd, Rd, Gg, Gg, Gg, Gg, Gg, Gg, Hh, Hh, Hh, Hh, Hh, Hhd^Fdf, Hhd^Fmf, Hhd^Fmf, Mm, Mm, Mm^Xm, Mm^Xm, Mm^Xm, Mm^Xm, Mm, Mm^Xm, Mm, Mm
Hh, Hh, Hh, Hh, Hh, Hh, Hh^Fp, Hh^Fp, Hh^Fp, Gs^Fp, Gs^Fp, Gg, Gg, Gs, Gs, Gg, Gg, Gg, Gg, Hh, Hh, Hh, Hh, Hh, Hh, Hhd^Fmf, Gd^Fdf, Hhd^Fdf, Hhd^Fdf, Mm, Mm, Mm, Mm, Mm^Xm, Mm^Xm, Mm, Mm
Hh, Hh, Hh, Hh, Hh, Hh, Hh, Hh, Hh, Hh, Hh^Fp, Gs^Fp, Gs, Gg, Gg, Rd, Rd, Rd, Gg^Vh, Hh, Gs^Fp, Hh, Hh, Hh, Hh, Gd^Fdf, Hh, Gd^Fdf, Gll^Fp, Gll^Fmf, Gll^Fmf, Md, Md, Mm^Xm, Mm^Xm, Md^Xm, Mm^Xm
Gd^Fdf, Hh, Hh, Hh, Hh, Hh, Hh, Hh, Hh, Hh, Hh, Chr, Chr, Gs, Gg, Gs^Fp, Gg, Rd, Gs, Gs^Fp, Gs^Fp, Gs^Fp, Gs^Fp, Hh, Hh, Hh, Hh, Hh, Hh, Gll^Fp, Gll^Fp, Gll^Fmf, Md, Md, Mm^Xm, Mm, Mm^Xm
Gd^Fdf, Gd^Fdf, Gd^Fdf, Gd^Fdf, Gs^Fds, Hh, Hh, Hh, Hh, Hh, Hh, 3 Khr, Chr, Chr, Gs^Fp, Gs^Fp, Gs^Fp, Gg, Gg, Rd, Rd, Gg, Gg, Gd, Hh, Hh, Hh, Hh, Gll^Fp, Gll^Fp, Gll^Fp, Gll^Fmf, Hhd, Md, Md, Md^Xm, Mm^Xm
Mm, Gd^Fdf, Mm, Gd^Fdf, Gs^Fds, Gs^Fds, Gs^Fds, Hh^Fp, Gll^Fp, Hh^Fp, Hh, Hh, Hh, Hh, Hh, Gs^Fp, Gs^Fp, Gs^Fp, Gg, Rd, Rd, Gg, Gg, Gg, Gs^Fp, Hh, Hh, Hh, Hh, Hh, Hh, Gll^Fp, Hhd, Md, Md, Mm^Xm, Mm^Xm
Mm^Xm, Mm, Mm^Xm, Mm, Mm, Gd^Fdf, Gd^Fdf, Hh^Fp, Hh^Fp, Gll^Fp, Gll^Fp, Hh^Fp, Hh, Hh, Hh, Hh, Hh, Gg, Gg, Gg, Rd, Rd, Gg, Gg, Gg, Gs^Fp, Gs^Fp, Hh, Hh, Hh, Gll^Fp, Gll^Fp, Gll^Fp, Gll^Fmf, Gll^Fmf, Md, Md
Mm^Xm, Mm^Xm, Mm^Xm, Hh, Mm, Mm, Gd^Fdf, Hhd^Fmf, Hh^Fp, Hh^Fp, Gll^Fp, Gs^Fds, Gll^Fmf, Hh, Hh, Hh, Hh, Gg, Gg, Gg, Gg, Gs, Rd, Gg, Gg, Gg, Gg, Gd, Hh, Hh, Gll^Fp, Gll^Fp, Gll^Fp, Gll^Fp, Gll^Fmf, Gd^Fdf, Gd^Fdf
Mm^Xm, Mm^Xm, Mm^Xm, Mm^Xm, Mm, Gd^Fdf, Gd^Fdf, Hhd^Fmf, Hhd^Fmf, Hhd^Fmf, Mm, Gs^Fds, Gs^Fds, Gll^Fp, Gll^Fp, Gll^Fp, Gll^Fp, Hh, Gg^Vh, Gg, Gg, Gg, Gg, Rd, Rd, Gg, Gg, Gg, Hh, Hh, Hh, Gll^Fp, Gs^Fds, Gll^Fp, Gs^Fds, Gs^Fds, Gs^Fds
Mm, Mm, Mm^Xm, Mm^Xm, Mm^Xm, Mm, Mm, Mm, Mm^Xm, Mm^Xm, Mm^Xm, Mm, Mm, Hhd, Hhd, Gd^Fdf, Gd^Fdf, Hh, Hh, Gg, Hh, Gg, Gg, Rd, Rd, Gg, Gg, Gg, Hh, Hh, Hh, Gll^Fp, Gs^Fds, Gs^Fds, Hhd^Fdf, Gs^Fds, Gs^Fds
Mm^Xm, Mm, Mm, Mm^Xm, Mm^Xm, Mm, Mm, Mm, Mm^Xm, Mm^Xm, Mm^Xm, Mm^Xm, Mm^Xm, Hhd, Md, Hhd, Gll^Fp, Hh, Hh, Hh, Hh, Gg, Gg, Gg, Rd, Rd, Gg^Vh, Gg, Hh, Hh, Hh, Hh, Hhd^Fdf, Hhd^Fdf, Hhd^Fdf, Hhd^Fdf, Gs^Fds
Mm^Xm, Mm^Xm, Mm^Xm, Mm, Mm^Xm, Mm^Xm, Mm^Xm, Mm^Xm, Mm, Mm^Xm, Mm^Xm, Mm^Xm, Mm^Xm, Mm^Xm, Md, Mm, Mm, Gll^Fp, Hh, Hh, Hh, Gs^Fp, Gs^Fp, Gg, Rd, Gg, Gs^Fp, Hh, Hh, Hh, Hh, Hh, Hhd^Fdf, Mm, Mm, Hhd^Fdf, Hhd^Fdf
Mm^Xm, Mm^Xm, Mm^Xm, Mm^Xm, Mm^Xm, Mm^Xm, Mm^Xm, Mm^Xm, Mm^Xm, Mm^Xm, Mm^Xm, Mm^Xm, Mm^Xm, Md, Md, Mm, Gll^Fp, Gll^Fp, Gll^Fp, Hh, Hh, Gs^Fp, Gs^Fp, Gg, Gs, Gg, Gs^Fp, Gs^Fp, Hh, Hh, Hh, Hh, Mm, Md, Md, Mm, Mm
Gs^Fds, Mm^Xm, Mm, Mm^Xm, Mm, Mm, Mm, Mm^Xm, Md, Mm^Xm, Md, Md, Md, Md, Mm, Hhd, Gll^Fp, Gll^Fp, Gll^Fp, Hh, Hh, Gs^Fp, Gs^Fp, Gg, Rd, Gg, Gs^Fp, Hh, Hh, Hh, Hh, Hhd^Fdf, Hhd^Fdf, Mm, Mm, Md, Mm^Xm
Gs^Fds, Hhd^Fmf, Hhd, Hhd, Hhd, Mm, Hhd^Fdf, Md, Hhd, Md, Hhd^Fdf, Hhd^Fmf, Hhd, Md, Hhd^Fmf, Gll^Fp, Gll^Fp, Hh, Hh, Hh, Gg^Vh, Gs^Fp, Gg, Gg, Rd, Gg, Hh, Hh, Hh, Hh, Hh, Hh^Fp, Hh^Fp, Mm, Mm^Xm, Mm^Xm, Mm^Xm
Gs^Fds, Gs^Fds, Hhd^Fmf, Hh, Hh, Hhd^Fdf, Hh, Hhd, Hh, Hhd, Hhd^Fdf, Hhd^Fdf, Hh, Hhd, Hh, Gd^Fdf, Hh, Hh, Hh, Hh, Gg, Gg, Gg, Rd, Rd, Gs^Fp, Chr, Chr, Hh, Hh, Hh, Hh^Fp, Md, Md, Mm^Xm, Md, Mm^Xm
Gs^Fds, Gs^Fds, Hh, Hh, Hh, Hh, Hh, Hh, Hh, Hh, Hh, Hh, Hh, Hh, Hh, Hh, Hh, Hh, Hh, Hh, Gg, Gg, Gg, Rd, Rd, Gs, Chr, 4 Khr, Chr, Hh, Hh, Gd^Fdf, Gd^Fdf, Md, Mm^Xm, Mm^Xm, Mm^Xm
Gs^Fds, Gs^Fds, Re, Hh, Re, Re, Re, Hh, Re, Hh, Hh, Hh, Hh, Hh, Hh, Hh, Hh, Hh, Hh, Hh, Gg, Gg^Efm, Gs^Fp, Gg, Gs, Gs, Gs, Chr, Chr, Hh, Hh, Hh, Hhd^Fdf, Mm, Md, Mm^Xm, Mm^Xm
Re, Re, Ww, Re, Ww, Re, Re, Re, Re, Re, Re, Hh, Hh, Hh, Gs, Hh, Hh, Hh, Hh, Hh, Gs^Fp, Gs^Fp, Gg^Fet, Gs^Fp, Gs^Fp, Gs, Rd, Gs, Gd, Gg^Vh, Gs, Hh, Hhd^Fdf, Mm, Mm, Mm^Xm, Mm^Xm
Ww, Ww, Wo, Ww, Ww, Ww^Vm, Ww, Ww, Ww, Re, Re, Re, Re, Re, Gs, Gs, Gs, Gs, Gs^Fp, Gs^Fp, Gs^Fp, Gs^Fp, Gs^Fp, Gs^Fp, Gs^Fp, Gs^Fp, Gs^Fp, Rd, Rd, Gd, Gs, Hh, Hh, Hhd^Fdf, Hh^Fds, Mm, Mm
Wo, Wo, Wo, Wo, Wo, Ww, Ww, Ww, Ww, Ww, Ww, Ww, Ww, Re, Re, Gs, Re, Gs, Gs^Fp, Gs^Fp, Gs^Fp, Gs^Fp, Gs^Fp, Gs^Fp, Gd, Gd, Gg^Vh, Gg, Rd, Gs, Gg, Hh, Hh, Hh, Hh^Fds, Hh^Fds, Hhd^Fdf
Wo, Wo, Wo, Wo, Ww, Ww, Wo, Ww, Wo, Ww, Ww, Ww, Ww, Wwrg, Wwrg, Re, Re, Re, Re, Gs, Gs, Gs, Gs, Gd, Gg, Gg, Gg, Gd, Gs, Rd, Gg, Hh, Hh, Hh, Gs^Fds, Hh^Fds, Hhd^Fdf
Wo, Wo, Wo, Wo, Wo, Wo, Wo, Wo, Wo, Wo, Wo, Wo, Wo, Wwr, Wwr, Re, Ww, Re, Re, Re, Re, Re, Re, Gs, Gs, Gg, Gg, Gg, Gs, Rd, Gg, Hh, Hh, Hh, Hh, Gs^Fds, Gs^Fds
Wo, Wo, Wo, Wo, Wo, Wo, Wo, Wo, Wo, Wo, Wo, Wo, Wo, Wo, Wo, Ww, Ww, Ww, Ww, Ww, Ww, Ww, Ww, Re, Re, Gs, Gs, Gs, Rp, Rp, Gs, Gg, Gg^Efm, Hh, Hh, Gs^Fds, Gll^Fp
Wo, Wo, Wo, Wo, Wo, Wo, Wo, Wo, Wo, Wo, Wo, Wo, Wo, Wo, Wo, Wo, Wo, Wo, Wo, Ww, Wo, Ww, Ww, Re, Ww, Re, Re, Gs, Rp, Rp, Gs^Vh, Gd, Gg^Efm, Gg^Efm, Hh, Hh, Gll^Fp
Ww, Wo, Wo, Wo, Wo, Wo, Wo, Wo, Wo, Wo, Ww, Wo, Wo, Wo, Wo, Wo, Ww, Ww, Ww, Wo, Ww, Wo, Wo, Ww, Ww, Wwf, Wwf, Rp, Rp, Rp, Gs, Gd, Gs^Fp, Gs^Fp, Gs^Fp, Gs^Fp, Gs^Fp
Re, Ww, Ww, Ww, Ww, Wo, Wo, Wo, Wo, Ww, Ww, Wo, Wo, Wo, Wo, Ww, Ww, Ww, Chw, Ww, Ww, Wo, Ww, Ww, Ww, Ww, Ww^Bw/, Ww^Bw/, Ww, Re, Re, Gs, Gs^Fp, Gs^Fp, Gs^Fp, Gs^Fp, Gs^Fp
Re, Wwrg, Re, Wwrg, Ch, Ww, Ww, Ww, Ww, Ww, Ww, Ww, Ww, Wo, Ww, Ww, Ww, Gg^Vh, 5 Khw, Chw, Ww, Ww, Ww, Ww, Ww^Bw/, Ww^Bw/, Ww, Ww, Wo, Ww, Ww, Re, Gs^Fms, Gs^Fp, Gs^Fp, Gs^Fp, Gs^Fp
Gs, Re, Gs, Re, Gs, Re, Re, Ch, Re, Wwrg, Ch, Ww, Ww, Ww, Ww, Ww, Ww^Bw/, Gg, Chw, Chw, Ww, Ww, Ww^Bw/, Ww^Bw/, Ww, Ww, Ww, Ww, Wo, Ww, Ww, Re, Re, Re, Re, Gs^Fp, Gs^Fp
Gs, Gs, Gs^Fp, Gs, Gs^Fp, Gs, Gs, Re, Gs, Re, Gs, Re, Ch, Ww, Ww^Bw/, Ww^Bw/, Ww, Ww, Ww, Ww, Ww^Bw/, Ww^Bw/, Ww, Ww, Ww, Ww, Wo, Wo, Wo, Wo, Wo, Ww, Ww, Wwrg, Ww, Re, Re
Gs^Fp, Gs^Fp, Gs^Fp, Gs^Fp, Gs^Fp, Gs^Fp, Gs^Fp, Gs, Gs, Gs^Wm, Gg, Gs, Rp, Rp, Ch, Ww, Wwf, Wwf, Ww^Bw/, Ww^Bw/, Ww, Ww, Ww, Ww, Wo, Wo, Wo, Wo, Wo, Wo, Wo, Wo, Wo, Ww, Wo, Ww, Ww
Gs^Fp, Gs^Fp, Gs^Fp, Gs^Fp, Gs^Fp, Gs^Fp, Gs^Fp, Gs^Fp, Gs, Gs, Gg, Gg, Gg, Gg, Gg, Ch, Rp, Rp, Rp, Wwf, Ww, Ww, Ww, Wo, Wo, Wo, Wo, Wo, Wo, Wo, Wo, Wo, Wo, Wo, Wo, Wo, Ww
Gs^Fp, Gs^Fp, Gs^Fp, Gs^Fp, Gs^Fp, Gs^Fp, Gs^Fp, Gs^Fp, Gs, Gs, Gg, Gg, Gg, Gg, Gg^Wm, Gg, Rp, Rp, Rp, Ch, Re, Ch, Wwrg, Ww, Ww, Wo, Wo, Wo, Wo, Wo, Wo, Wo, Wo, Wo, Wo, Wo, Ww
Gs^Fp, Gs^Fp, Gs^Fp, Gg^Fet, Gs^Fp, Gs^Fp, Gs^Fp, Gs^Fp, Gs, Gg, Gg, Gg, Gg, Gg, Gg, Gg, Rp, Rp, Rp, Rr^Vhc, Re, Re, Re, Ww, Ww, Ww, Ww, Wo, Wo, Wo, Wo, Wo, Wo, Wo, Wo, Wo, Wo
Gs^Fp, Gs^Fp, Gs^Fp, Gs^Fp, Gs^Fp, Gs^Fp, Gs^Fp, Gs^Fp, Gs, Gs, Gg, Gg, Rp, Ch, Rp, Rp, Rp, Rp, Gg, Gs, Gs^Wm, Gs, Gs, Ch, Re, Ww, Wwrg, Ww, Ww, Ww, Ww, Wo, Wo, Wo, Wo, Wo, Wo
Gs^Fp, Gs^Fp, Gs^Fp, Gs^Fp, Gs^Fp, Gs^Fp, Gs^Fp, Gs, Gs, Gg, Gg, Gg^Vh, Rp, Rp, Rp, Rp, Gg, Gg, Gg, Gg, Gs, Gs, Gs, Gs, Gs, Ch, Re, Re, Ch, Ww, Ww, Wo, Wo, Wo, Wo, Wo, Wo
Gs^Fp, Gs^Fp, Gs^Fp, Gs^Fp, Gs^Fp, Gs^Fp, Gs, Gs, Gg, Gg, Rp, Rp, Rp, Rp, Gg, Gg, Gg, Gg, Gs, Gs, Gs^Fp, Gs^Fp, Gs^Fp, Gs, Gs, Gs, Gs, Re, Gs, Ch, Re, Ww, Ww, Wo, Ww, Wo, Wo
Gs^Fp, Gs^Fp, Gs^Fp, Gs^Fp, Gs, Gs, Gg, Gg, Rp, Rp, Rp, Rp, Rp, Gg, Gg, Gg, Gg, Gg, Gs, Gs^Fp, Gs^Fp, Gs^Fp, Gs^Fp, Gs^Fp, Gs, Gs, Gs, Gs, Gs, Gs, Re, Re, Re, Ww, Ww, Ww, Ww
